50,45
1,1,50,25
8
9,1,9,9,16,9,16,1
30,2,47,2,47,10,30,10
3,14,17,14,17,25,3,25
23,14,50,14,50,24,23,24
15,29,28,29,28,43,15,43
5,34,10,34,10,45,5,45
29,31,29,39,37,39,37,31
38,25,40,25,40,32,38,32