22,18
2,2,10,8,4,3,18,2,2,18
5
4,4,5,9,8,10,9,5
8,11,8,16,13,11
10,1,10,6,14,6,14,1
12,8,12,10,18,10,18,8
15,4,15,6,22,6,22,4