11,12
1,1,6,11,8,5,9,6,5,9
6
1,3,1,4,5,4,5,3
9,3,9,5,10,5,10,3
6,6,6,7,8,7,8,6
3,7,3,10,5,10
6,10,7,10,7,11
9,9,9,10,10,11,10,8